00000000000000000000000000000000000000000000000000000000000000000011110000000000000000000000001111000000000000000000000000111100000000000000
00000000000000000000000000000000000000000000000000000000000000000011110000000000000000000000001111000000000000000000000000111100000000000000
00000000000000000000000000000000000000000000000000000000000000000011110000000000000000000000001111000000000000000000000000111100000000000000
00000000000000000000000000000000000000000000000000000000000000000011110000000000000000000000001111000000000000000000000000111100000000000000
00000000000000000000000000000000000000000000000000000000000000000011110000000000000000000000001111000000000000000000000000111100000000000000
00000000000000000000000000000000000000000000000000000000000000000011110000000000000000000000001111000000000000000000000000111100000000000000
00000000000000000000000000000000000000000000000000000000000000000011110000000000000000000000001111000000000000000000000000111100000000000000
00000000000000000000000000000000000000000000000000000000000000000011110000000000000000000000001111000000000000000000000000111100000000000000
00000000000000000000000000000000000000000000000000000000000000000011110000000000000000000000001111000000000000000000000000111100000000000000
00000000000000000000000000000000000000023000000000000000000000000111100000000000000000000000011110000000000000000000000001111000000000000000
00000000001111000000000000022020000000000001111111111111111111111111110000000000000000000000001111000000000000000000000000111100000000000000
