0000000000000000000000000000023000000000000000000000000000000023000000002300000000000000000000000000000000000000000000000000040
0000000000000000000000000000023000000000000000000000000000000023000000002300000000000000000000000000000000000000000000000000040
0000000000000000000000000000023000000000000000000000000000000023000000002300000000000000000000000000000000000000000000000000040
0000000000000000000000000000023000000000000000000000000000000023000000002300000000000000000000000000000000000000000000000000040
0000000000000000000000000000023000000000000000000000000000000023000000002300000000000000000000000000000000000000000000000000040
0000000000000000000000000000023000000000000000000000000000000023000000002300000000000000000000000000000000000000000000000000040
0000000000000000000000000000000000000000000000000000000000000000000000000000000000000000000000000000000000000000000000000000040
0000000000000000000000000000000000000000000000000000000000000000000000000000000000000000000000000000000000000000000000000000040
0000000000000000000000000000000000000000000000000000000000000000000000000000000000000000000000000000000000000000000000000000040
0000000000000000001100000000001000000001100000000000000000000001000000000100000000000000000000000100000000001100000000000000040
0000000000000000003300000000003000000003300000000011100000000003000000000300000000000011000000002300000000003300000000001000040