00000000000000000000000000000000000000000000000000000000000000000011110000000000000000000000001111000000000000000000000000111100000000000043
00000000000000000000000000000000000000000000000000000000000000000011110000000000000000000000001111000000000000000000000000111100000000000043
00000000000000000000000000000000000000000000000000000000000000000011110000000000000000000000001111000000000000000000000000111100000000000043
00000000000000000000000000000000000000000000000000000000000000000011110000000000000000000000001111000000000000000000000000111100000000000043
00000000000000000000000000000000000000000000000000000000000000000011110000000000000000000000001111000000000000000000000000111100000000000043
00000000000000000000000000000000000000000000000000000000000000000011110000000000000000000000001111000000000000000000000000111100000000000043
00000000000000000000000000000000000000000000000000000000000000000011110000000000000000000000001111000000000000000000000000111100000000000043
00000000000000000000000000000000000000000000000000000000000000000011110000000000000000000000001111000000000000000000000000111100000000000043
00000000000000000000000000000000000000000000000000000000000000000011110000000000000000000000001111000000000000000000000000111100000000000043
00000000000000333300000000000000000000002300000000000000000000000011110000000000000000000000001111000000000000000000000000111100000000000043
00000000000000000340030030022020000000000000000001111111111111111111111111110000000000000000000000001111000000000000000000000000111100000043