00000000000000000000000000000000000000000000000000000000000000000011110000000000000000000000001111000000000000000000000000111100000000000003
00000000000000000000000000000000000000000000000000000000000000000011110000000000000000000000001111000000000000000000000000111100000000000003
00000000000000000000000000000000000000000000000000000000000000000011110000000000000000000000001111000000000000000000000000111100000000000003
00000000000000000000000000000000000000000000000000000000000000000011110000000000000000000000001111000000000000000000000000111100000000000003
00000000000000000000000000000000000000000000000000000000000000000011110000000000000000000000001111000000000000000000000000111100000000000003
00000000000000000000000000000000000000000000000000000000000000000011110000000000000000000000001111000000000000000000000000111100000000000003
00000000000000000000000000000000000000000000000000000000000000000011110000000000000000000000001111000000000000000000000000111100000000000003
00000000000000000000000000000000000000000000000000000000000000000011110000000000000000000000001111000000000000000000000000111100000000000003
00000000000000000000000000000000000000000000000000000000000000000011110000000000000000000000001111000000000000000000000000111100000000000003
00000000000000000300030000000000000000023000000000000000000000000111100000000000000000000000011110000000000000000000000001111000000000000003
00000000001111000300030000022020000000000000000001111111111111111111111111110000000000000000000000001111000000000000000000000000111100000003